000000020
000000020
000000000
000000000
11030000x
000300000
000300000
000300000
000000000